6 9

1 1 1 1 1 1 1 1 1 
1 1 1 1 1 1 2 2 1 
1 1 1 1 1 1 2 2 1 
1 1 1 1 1 1 1 1 1 
1 1 1 1 1 1 1 1 1 
1 1 1 1 1 1 1 1 1 


6

1 0 2
1 0 1
1 0 3
1 1 2
1 2 2
1 1 3
