9 9

0 0 1 1 1 1 0 0 0 
0 1 1 1 1 1 1 0 0 
0 1 1 1 1 1 1 0 0 
1 1 2 1 1 1 1 1 0 
1 2 2 1 1 1 1 1 0 
1 1 2 1 1 1 1 1 0 
0 1 1 1 1 1 1 0 0 
0 1 1 1 1 1 1 0 0 
0 0 1 1 1 1 0 0 0 


6

1 0 3
1 0 4
4 0 6
4 0 5
7 0 3
7 0 4
