10 10

1 1 1 1 1 1 1 1 1 1 
1 1 1 1 1 1 1 1 1 1 
1 1 1 1 1 1 1 1 1 1 
1 1 1 1 1 1 1 1 1 1 
1 1 1 1 1 1 1 1 1 1 
1 1 1 1 1 1 1 1 1 1 
1 2 1 1 1 1 1 1 1 1 
1 2 1 1 1 1 0 0 1 1 
1 2 2 1 1 1 1 1 1 1 
1 1 1 1 1 1 1 1 1 1 


5

4 0 1
4 1 1
4 2 1
4 3 1
4 4 1
