14 13

1 1 1 1 0 0 0 1 1 1 1 1 1 
1 1 1 1 0 0 0 1 1 1 1 1 1 
1 1 1 1 0 0 0 1 1 1 1 1 1 
1 1 1 1 0 0 0 1 1 1 1 1 1 
1 1 1 1 0 0 0 1 1 2 1 1 1 
1 1 1 1 0 0 0 1 2 2 2 1 1 
1 1 1 1 0 0 0 1 1 2 1 1 1 
1 1 1 1 0 0 0 1 1 1 1 1 1 
0 0 0 0 0 0 0 0 0 0 0 0 0 
0 0 0 0 0 0 0 1 1 1 1 1 0 
0 1 1 1 1 1 0 1 1 1 1 1 0 
0 1 1 1 1 1 0 1 1 1 1 1 0 
0 1 1 1 1 1 0 1 1 1 1 1 0 
0 1 1 1 1 1 0 1 1 1 1 1 0 


13

4 0 2
4 1 2
4 2 2
12 0 2
12 0 9
13 0 9
12 0 10
12 0 8
3 0 11
3 1 11
12 0 1
3 2 11
0 0 2
