20 15

0 0 0 0 0 0 0 0 0 0 0 0 0 0 0
0 2 2 2 2 0 0 0 0 0 2 2 2 2 0
0 2 1 1 2 2 2 0 2 2 2 1 1 2 0
0 2 1 1 1 1 2 2 2 1 1 1 1 2 0
0 2 1 1 1 1 1 1 1 1 1 1 1 2 0
0 2 1 1 1 1 1 1 1 1 1 1 1 2 0
2 2 1 1 1 1 1 1 1 1 1 1 1 2 2
2 1 1 1 1 1 1 1 1 1 1 1 1 1 2
2 1 1 1 1 1 1 1 0 1 1 1 1 1 2
2 1 1 1 1 1 1 1 1 1 1 1 1 1 2
2 1 1 1 1 1 1 1 1 1 1 1 1 1 2
2 1 1 1 1 1 1 1 1 1 1 1 1 1 2
2 1 1 1 1 1 1 1 1 1 1 1 1 1 2
2 1 1 1 1 1 1 1 1 1 1 1 1 2 2
2 2 1 1 1 1 1 1 1 1 1 1 1 2 0
0 2 1 1 1 1 1 1 1 1 1 1 1 2 0
0 2 1 1 1 1 2 2 2 1 1 1 1 2 0
0 2 1 1 2 2 2 0 2 2 2 1 1 2 0
0 2 2 2 2 0 0 0 0 0 2 2 2 2 0
0 0 0 0 0 0 0 0 0 0 0 0 0 0 0

9

9 0 7
9 0 6
9 0 5
8 0 7
7 0 7
6 0 7
5 0 7
4 0 7
3 0 7
