7 6

1 1 1 1 1 1 
1 1 1 1 1 1 
1 1 1 1 1 1 
1 1 1 1 1 1 
1 1 2 1 1 1 
1 2 2 1 1 1 
1 1 1 1 1 1 


3

2 0 3
1 0 3
2 0 1
